             #########
          ###         ###
       ###             ###
     ##                  ###
   ##      ##########     ##
  ##      ##        ##      ##
 ##       ##        ##       ##
 ##        ##      ##        ##
 ##         ########         ##
   ##                       ##
    ###                   ###
      ###               ###
         ###         ###
            #########
