xxxxxxxxxxxxxxxxxxx
x         P       x
x                 x
x                 x
x              M  x
x              x  x
x     tR       x  x
x    xxxxxxxxxxx  x
x    xxxxxxxxxxx  x
xxxxxxxxxxxxxxxxxxx