MMMMMMMMMMMMMMMMMMMMMMMMMMMMMMMMM
M     l            MMMMMMMMMMMMMM
M           l      MMMMMMMMMMMMMM
M
MP
GG
LLGG           RtR      u
LLLLGG t       GGGGGGGGGGGGGGGGGG
LLLLLLGG    EGGGLLLLLLLLLLLLLLLLL
LLLLLLLLGGGGGLLLLLLLLLLLLLLLLLLLL
LLLLLLLLLLLLLLLLLLLLLLLLLLLLLLLLL